A1 | Hoa  |  500  |  20
A2 | La   |  300  |  70
A4 | Canh |  700  |  30
A3 | Cay  |  400  |  50
A6 | Goc  |  200  |  90
A5 | Re   |  600  |  40
